NO  ./texture/bricks1.png
SO ./texture/neon1.png
WE ./texture/bricks3.png
EA ./texture/neon.png

F 110,210,10
C 25,25,25



11111111111
10000000001
10010100001
10000000001
1000N000001
11111111111