111111111
100100001
101000001
1100N0001
111111111
