111111111111111111111111
100000000000000000000001
100000000000000000000001
100000000000000000000001
100000111110000101010001
100000100010000000000001
100000100010000100010001
100000100010000000000001
100000110110000101010001
100000000000000000000001
100000000000000000000001
100000000000000000100001
111111111111111111100001
100000000000000000100001
100000000000000000100001
100000000000000000100001
111111111000000000100001
110100001000000000100001
11000010100N000000100001
110100001000000000100001
11011111100000000N100001
110000000000000000000001
111111111000000000000001
111111111111111111111111    